R 640 480

SO  ./textures/south.xpm
NO  ./textures/north.xpm
WE  ./textures/west.xpm
EA  ./textures/east.xpm
S   ./textures/sprite.xpm

F   0, 100, 0
C   30, 140, 255

     11111111111111111111111111111
     10000000000000000000000000001
     10000000000000000000000111111
11111100000000000000000000001
10000000000000000000000000001
10000002000000000000002000001
10000000000000000000000000001
10000010000001000000000000001
10000010000000000000000000001
10000010000000000000000000001
10000000000000000000000100001
10000000000001111111000000001
10000000000001     1000000001
10000000000001   1110000000N1
10000000000001   100000000001
11111111111111   111111111111