R 2000 2000

NO ./textures/wood.xpm
SO ./textures/brick.xpm
WE ./textures/brick.xpm
EA ./textures/wood.xpm
S ./textures/cow.xpm

F   255, 0, 0
C   0, 0, 255

     11111111111111111111111111111
     10000000000000000000000000001
     10000200000000000000000111111
11111100000000000000000000001
100000N0000020000000000000001
10000002000000000000002000001
10000000000000000000000000001
10111111111111111111111111111
101 
10111111111111111111111111111
10000010000000000000000000001
10000010000000000000000000001
10000000000000000000000100001
10000000000001111111000000001
10000000000001     1000000001
10000000000001   111000000001
10000000000001   100000000001
11111111111111   111111111111