WE textures/mossy.xpm
EA textures/eagle.xpm

S textures/pillar.xpm
R 3000 3000
F 184,113,39
C 51,198,227
NO textures/redbrick.xpm
SO textures/purplestone.xpm

11111111111111111111111111111
10000000001100000000000000001
10110000011100000000000010001
10010000000000000000000010001
10110000011100000000000010001
10000000001100000111011110001
11110111111111011100000010001
11110111111111011101010010001
11000000110101011100000010001
10000000000000001100000010001
10000000000000001102010020001
11000000110101000000000000001
11110111110101000000202000001
10000000001100000100000010001
10000000000000002000200001001
10000000001000010000000001001
10200000001101000000000000001
1N000000000100000001010000001
11111111111111111111111111111
