R 1000 1000

SO  ./textures/south.xpm
NO  ./textures/north.xpm
WE  ./textures/west.xpm
EA  ./textures/east.xpm
S   ./textures/sprite.xpm

F   0, 100, 0
C   30, 140, 255

111111
100001
100001
100N01
111111